Representando v-ger ini=cap cap=maxmin simb=alpha prevW=null prevT=null prevCap=null nextW=o nextT=art nextCap=min prev2W=null prev2T=null prev2Cap=null next2W=corpo next2T=n next2Cap=min palpite=O
o art ini=ncap cap=min simb=alpha prevW=Representando prevT=v-ger prevCap=maxmin nextW=corpo nextT=n nextCap=min prev2W=null prev2T=null prev2Cap=null next2W=discente next2T=n next2Cap=min palpite=O
corpo n ini=ncap cap=min simb=alpha prevW=o prevT=art prevCap=min nextW=discente nextT=n nextCap=min prev2W=Representando prev2T=v-ger prev2Cap=maxmin next2W=, next2T=punc next2Cap=null palpite=O
discente n ini=ncap cap=min simb=alpha prevW=corpo prevT=n prevCap=min nextW=, nextT=punc nextCap=null prev2W=o prev2T=art prev2Cap=min next2W=respectivos next2T=adj next2Cap=min palpite=O
, punc ini=simb cap=null simb=null prevW=discente prevT=n prevCap=min nextW=respectivos nextT=adj nextCap=min prev2W=corpo prev2T=n prev2Cap=min next2W=titulares next2T=n next2Cap=min palpite=O
respectivos adj ini=ncap cap=min simb=alpha prevW=, prevT=punc prevCap=null nextW=titulares nextT=n nextCap=min prev2W=discente prev2T=n prev2Cap=min next2W=e next2T=conj-c next2Cap=min palpite=O
titulares n ini=ncap cap=min simb=alpha prevW=respectivos prevT=adj prevCap=min nextW=e nextT=conj-c nextCap=min prev2W=, prev2T=punc prev2Cap=null next2W=suplentes next2T=n next2Cap=min palpite=O
e conj-c ini=ncap cap=min simb=alpha prevW=titulares prevT=n prevCap=min nextW=suplentes nextT=n nextCap=min prev2W=respectivos prev2T=adj prev2Cap=min next2W=: next2T=punc next2Cap=null palpite=O
suplentes n ini=ncap cap=min simb=alpha prevW=e prevT=conj-c prevCap=min nextW=: nextT=punc nextCap=null prev2W=titulares prev2T=n prev2Cap=min next2W=Douglas next2T=n next2Cap=maxmin palpite=O
: punc ini=simb cap=null simb=null prevW=suplentes prevT=n prevCap=min nextW=Douglas nextT=n nextCap=maxmin prev2W=e prev2T=conj-c prev2Cap=min next2W=Nascimento next2T=n next2Cap=maxmin palpite=O
Douglas n ini=cap cap=maxmin simb=alpha prevW=: prevT=punc prevCap=null nextW=Nascimento nextT=n nextCap=maxmin prev2W=suplentes prev2T=n prev2Cap=min next2W=dos next2T=n next2Cap=min palpite=I_PESSOA
Nascimento n ini=cap cap=maxmin simb=alpha prevW=Douglas prevT=n prevCap=maxmin nextW=dos nextT=n nextCap=min prev2W=: prev2T=punc prev2Cap=null next2W=Santos next2T=n next2Cap=maxmin palpite=I_PESSOA
dos n ini=ncap cap=min simb=alpha prevW=Nascimento prevT=n prevCap=maxmin nextW=Santos nextT=n nextCap=maxmin prev2W=Douglas prev2T=n prev2Cap=maxmin next2W=e next2T=conj-c next2Cap=min palpite=I_PESSOA
Santos n ini=cap cap=maxmin simb=alpha prevW=dos prevT=n prevCap=min nextW=e nextT=conj-c nextCap=min prev2W=Nascimento prev2T=n prev2Cap=maxmin next2W=Wilherme next2T=prop next2Cap=maxmin palpite=I_PESSOA
e conj-c ini=ncap cap=min simb=alpha prevW=Santos prevT=n prevCap=maxmin nextW=Wilherme nextT=prop nextCap=maxmin prev2W=dos prev2T=n prev2Cap=min next2W=Borchardt next2T=prop next2Cap=maxmin palpite=O
Wilherme prop ini=cap cap=maxmin simb=alpha prevW=e prevT=conj-c prevCap=min nextW=Borchardt nextT=prop nextCap=maxmin prev2W=Santos prev2T=n prev2Cap=maxmin next2W=; next2T=punc next2Cap=null palpite=O
Borchardt prop ini=cap cap=maxmin simb=alpha prevW=Wilherme prevT=prop prevCap=maxmin nextW=; nextT=punc nextCap=null prev2W=e prev2T=conj-c prev2Cap=min next2W=Diego next2T=n next2Cap=maxmin palpite=O
; punc ini=simb cap=null simb=null prevW=Borchardt prevT=prop prevCap=maxmin nextW=Diego nextT=n nextCap=maxmin prev2W=Wilherme prev2T=prop prev2Cap=maxmin next2W=Silva next2T=prop next2Cap=maxmin palpite=O
Diego n ini=cap cap=maxmin simb=alpha prevW=; prevT=punc prevCap=null nextW=Silva nextT=prop nextCap=maxmin prev2W=Borchardt prev2T=prop prev2Cap=maxmin next2W=Graziotti next2T=prop next2Cap=maxmin palpite=I_PESSOA
Silva prop ini=cap cap=maxmin simb=alpha prevW=Diego prevT=n prevCap=maxmin nextW=Graziotti nextT=prop nextCap=maxmin prev2W=; prev2T=punc prev2Cap=null next2W=e next2T=conj-c next2Cap=min palpite=I_PESSOA
Graziotti prop ini=cap cap=maxmin simb=alpha prevW=Silva prevT=prop prevCap=maxmin nextW=e nextT=conj-c nextCap=min prev2W=Diego prev2T=n prev2Cap=maxmin next2W=Vitor next2T=n next2Cap=maxmin palpite=I_PESSOA
e conj-c ini=ncap cap=min simb=alpha prevW=Graziotti prevT=prop prevCap=maxmin nextW=Vitor nextT=n nextCap=maxmin prev2W=Silva prev2T=prop prev2Cap=maxmin next2W=Andrade next2T=prop next2Cap=maxmin palpite=O
Vitor n ini=cap cap=maxmin simb=alpha prevW=e prevT=conj-c prevCap=min nextW=Andrade nextT=prop nextCap=maxmin prev2W=Graziotti prev2T=prop prev2Cap=maxmin next2W=Rebouças next2T=n next2Cap=maxmin palpite=I_PESSOA
Andrade prop ini=cap cap=maxmin simb=alpha prevW=Vitor prevT=n prevCap=maxmin nextW=Rebouças nextT=n nextCap=maxmin prev2W=e prev2T=conj-c prev2Cap=min next2W=; next2T=punc next2Cap=null palpite=I_PESSOA
Rebouças n ini=cap cap=maxmin simb=alpha prevW=Andrade prevT=prop prevCap=maxmin nextW=; nextT=punc nextCap=null prev2W=Vitor prev2T=n prev2Cap=maxmin next2W=Juliana next2T=n next2Cap=maxmin palpite=I_PESSOA
; punc ini=simb cap=null simb=null prevW=Rebouças prevT=n prevCap=maxmin nextW=Juliana nextT=n nextCap=maxmin prev2W=Andrade prev2T=prop prev2Cap=maxmin next2W=Alice next2T=n next2Cap=maxmin palpite=O
Juliana n ini=cap cap=maxmin simb=alpha prevW=; prevT=punc prevCap=null nextW=Alice nextT=n nextCap=maxmin prev2W=Rebouças prev2T=n prev2Cap=maxmin next2W=Lino next2T=n next2Cap=maxmin palpite=I_PESSOA
Alice n ini=cap cap=maxmin simb=alpha prevW=Juliana prevT=n prevCap=maxmin nextW=Lino nextT=n nextCap=maxmin prev2W=; prev2T=punc prev2Cap=null next2W=de next2T=prp next2Cap=min palpite=I_PESSOA
Lino n ini=cap cap=maxmin simb=alpha prevW=Alice prevT=n prevCap=maxmin nextW=de nextT=prp nextCap=min prev2W=Juliana prev2T=n prev2Cap=maxmin next2W=Souza next2T=prop next2Cap=maxmin palpite=I_PESSOA
de prp ini=ncap cap=min simb=alpha prevW=Lino prevT=n prevCap=maxmin nextW=Souza nextT=prop nextCap=maxmin prev2W=Alice prev2T=n prev2Cap=maxmin next2W=e next2T=conj-c next2Cap=min palpite=I_PESSOA
Souza prop ini=cap cap=maxmin simb=alpha prevW=de prevT=prp prevCap=min nextW=e nextT=conj-c nextCap=min prev2W=Lino prev2T=n prev2Cap=maxmin next2W=Suellen next2T=prop next2Cap=maxmin palpite=I_PESSOA
e conj-c ini=ncap cap=min simb=alpha prevW=Souza prevT=prop prevCap=maxmin nextW=Suellen nextT=prop nextCap=maxmin prev2W=de prev2T=prp prev2Cap=min next2W=Oliveira next2T=prop next2Cap=maxmin palpite=O
Suellen prop ini=cap cap=maxmin simb=alpha prevW=e prevT=conj-c prevCap=min nextW=Oliveira nextT=prop nextCap=maxmin prev2W=Souza prev2T=prop prev2Cap=maxmin next2W=Colli next2T=prop next2Cap=maxmin palpite=O
Oliveira prop ini=cap cap=maxmin simb=alpha prevW=Suellen prevT=prop prevCap=maxmin nextW=Colli nextT=prop nextCap=maxmin prev2W=e prev2T=conj-c prev2Cap=min next2W=. next2T=punc next2Cap=null palpite=I_PESSOA
Colli prop ini=cap cap=maxmin simb=alpha prevW=Oliveira prevT=prop prevCap=maxmin nextW=. nextT=punc nextCap=null prev2W=Suellen prev2T=prop prev2Cap=maxmin next2W=null next2T=null next2Cap=null palpite=I_PESSOA
. punc ini=simb cap=null simb=null prevW=Colli prevT=prop prevCap=maxmin nextW=null nextT=null nextCap=null prev2W=Oliveira prev2T=prop prev2Cap=maxmin next2W=null next2T=null next2Cap=null palpite=O
