Representando v-ger ini=cap cap=maxmin simb=alpha prevW=null prevT=null prevCap=null nextW=o nextT=art nextCap=min prev2W=null prev2T=null prev2Cap=null next2W=corpo next2T=n next2Cap=min palpite=O
o art ini=ncap cap=min simb=alpha prevW=Representando prevT=v-ger prevCap=maxmin nextW=corpo nextT=n nextCap=min prev2W=null prev2T=null prev2Cap=null next2W=Técnico next2T=n next2Cap=maxmin palpite=O
corpo n ini=ncap cap=min simb=alpha prevW=o prevT=art prevCap=min nextW=Técnico nextT=n nextCap=maxmin prev2W=Representando prev2T=v-ger prev2Cap=maxmin next2W=Administrativo next2T=n next2Cap=maxmin palpite=O
Técnico n ini=cap cap=maxmin simb=alpha prevW=corpo prevT=n prevCap=min nextW=Administrativo nextT=n nextCap=maxmin prev2W=o prev2T=art prev2Cap=min next2W=, next2T=punc next2Cap=null palpite=O
Administrativo n ini=cap cap=maxmin simb=alpha prevW=Técnico prevT=n prevCap=maxmin nextW=, nextT=punc nextCap=null prev2W=corpo prev2T=n prev2Cap=min next2W=respectivos next2T=adj next2Cap=min palpite=O
, punc ini=simb cap=null simb=null prevW=Administrativo prevT=n prevCap=maxmin nextW=respectivos nextT=adj nextCap=min prev2W=Técnico prev2T=n prev2Cap=maxmin next2W=titulares next2T=n next2Cap=min palpite=O
respectivos adj ini=ncap cap=min simb=alpha prevW=, prevT=punc prevCap=null nextW=titulares nextT=n nextCap=min prev2W=Administrativo prev2T=n prev2Cap=maxmin next2W=e next2T=conj-c next2Cap=min palpite=O
titulares n ini=ncap cap=min simb=alpha prevW=respectivos prevT=adj prevCap=min nextW=e nextT=conj-c nextCap=min prev2W=, prev2T=punc prev2Cap=null next2W=suplentes next2T=n next2Cap=min palpite=O
e conj-c ini=ncap cap=min simb=alpha prevW=titulares prevT=n prevCap=min nextW=suplentes nextT=n nextCap=min prev2W=respectivos prev2T=adj prev2Cap=min next2W=: next2T=punc next2Cap=null palpite=O
suplentes n ini=ncap cap=min simb=alpha prevW=e prevT=conj-c prevCap=min nextW=: nextT=punc nextCap=null prev2W=titulares prev2T=n prev2Cap=min next2W=Evandro next2T=n next2Cap=maxmin palpite=O
: punc ini=simb cap=null simb=null prevW=suplentes prevT=n prevCap=min nextW=Evandro nextT=n nextCap=maxmin prev2W=e prev2T=conj-c prev2Cap=min next2W=das next2T=n next2Cap=min palpite=O
Evandro n ini=cap cap=maxmin simb=alpha prevW=: prevT=punc prevCap=null nextW=das nextT=n nextCap=min prev2W=suplentes prev2T=n prev2Cap=min next2W=Virgens next2T=n next2Cap=maxmin palpite=I_PESSOA
das n ini=ncap cap=min simb=alpha prevW=Evandro prevT=n prevCap=maxmin nextW=Virgens nextT=n nextCap=maxmin prev2W=: prev2T=punc prev2Cap=null next2W=Scarpati next2T=prop next2Cap=maxmin palpite=I_PESSOA
Virgens n ini=cap cap=maxmin simb=alpha prevW=das prevT=n prevCap=min nextW=Scarpati nextT=prop nextCap=maxmin prev2W=Evandro prev2T=n prev2Cap=maxmin next2W=e next2T=conj-c next2Cap=min palpite=I_PESSOA
Scarpati prop ini=cap cap=maxmin simb=alpha prevW=Virgens prevT=n prevCap=maxmin nextW=e nextT=conj-c nextCap=min prev2W=das prev2T=n prev2Cap=min next2W=Dárcio next2T=n next2Cap=maxmin palpite=I_PESSOA
e conj-c ini=ncap cap=min simb=alpha prevW=Scarpati prevT=prop prevCap=maxmin nextW=Dárcio nextT=n nextCap=maxmin prev2W=Virgens prev2T=n prev2Cap=maxmin next2W=Leitão next2T=n next2Cap=maxmin palpite=O
Dárcio n ini=cap cap=maxmin simb=alpha prevW=e prevT=conj-c prevCap=min nextW=Leitão nextT=n nextCap=maxmin prev2W=Scarpati prev2T=prop prev2Cap=maxmin next2W=Quintas next2T=adj next2Cap=maxmin palpite=O
Leitão n ini=cap cap=maxmin simb=alpha prevW=Dárcio prevT=n prevCap=maxmin nextW=Quintas nextT=adj nextCap=maxmin prev2W=e prev2T=conj-c prev2Cap=min next2W=; next2T=punc next2Cap=null palpite=O
Quintas adj ini=cap cap=maxmin simb=alpha prevW=Leitão prevT=n prevCap=maxmin nextW=; nextT=punc nextCap=null prev2W=Dárcio prev2T=n prev2Cap=maxmin next2W=Giselly next2T=prop next2Cap=maxmin palpite=O
; punc ini=simb cap=null simb=null prevW=Quintas prevT=adj prevCap=maxmin nextW=Giselly nextT=prop nextCap=maxmin prev2W=Leitão prev2T=n prev2Cap=maxmin next2W=Ferreira next2T=prop next2Cap=maxmin palpite=O
Giselly prop ini=cap cap=maxmin simb=alpha prevW=; prevT=punc prevCap=null nextW=Ferreira nextT=prop nextCap=maxmin prev2W=Quintas prev2T=adj prev2Cap=maxmin next2W=Martins next2T=prop next2Cap=maxmin palpite=O
Ferreira prop ini=cap cap=maxmin simb=alpha prevW=Giselly prevT=prop prevCap=maxmin nextW=Martins nextT=prop nextCap=maxmin prev2W=; prev2T=punc prev2Cap=null next2W=e next2T=conj-c next2Cap=min palpite=I_PESSOA
Martins prop ini=cap cap=maxmin simb=alpha prevW=Ferreira prevT=prop prevCap=maxmin nextW=e nextT=conj-c nextCap=min prev2W=Giselly prev2T=prop prev2Cap=maxmin next2W=Paula next2T=n next2Cap=maxmin palpite=I_PESSOA
e conj-c ini=ncap cap=min simb=alpha prevW=Martins prevT=prop prevCap=maxmin nextW=Paula nextT=n nextCap=maxmin prev2W=Ferreira prev2T=prop prev2Cap=maxmin next2W=Mariani next2T=prop next2Cap=maxmin palpite=O
Paula n ini=cap cap=maxmin simb=alpha prevW=e prevT=conj-c prevCap=min nextW=Mariani nextT=prop nextCap=maxmin prev2W=Martins prev2T=prop prev2Cap=maxmin next2W=Damiani next2T=n next2Cap=maxmin palpite=I_PESSOA
Mariani prop ini=cap cap=maxmin simb=alpha prevW=Paula prevT=n prevCap=maxmin nextW=Damiani nextT=n nextCap=maxmin prev2W=e prev2T=conj-c prev2Cap=min next2W=Taquete next2T=n next2Cap=maxmin palpite=I_PESSOA
Damiani n ini=cap cap=maxmin simb=alpha prevW=Mariani prevT=prop prevCap=maxmin nextW=Taquete nextT=n nextCap=maxmin prev2W=Paula prev2T=n prev2Cap=maxmin next2W=; next2T=punc next2Cap=null palpite=I_PESSOA
Taquete n ini=cap cap=maxmin simb=alpha prevW=Damiani prevT=n prevCap=maxmin nextW=; nextT=punc nextCap=null prev2W=Mariani prev2T=prop prev2Cap=maxmin next2W=Anderson next2T=prop next2Cap=maxmin palpite=I_PESSOA
; punc ini=simb cap=null simb=null prevW=Taquete prevT=n prevCap=maxmin nextW=Anderson nextT=prop nextCap=maxmin prev2W=Damiani prev2T=n prev2Cap=maxmin next2W=Dias next2T=n next2Cap=maxmin palpite=O
Anderson prop ini=cap cap=maxmin simb=alpha prevW=; prevT=punc prevCap=null nextW=Dias nextT=n nextCap=maxmin prev2W=Taquete prev2T=n prev2Cap=maxmin next2W=de next2T=prp next2Cap=min palpite=I_PESSOA
Dias n ini=cap cap=maxmin simb=alpha prevW=Anderson prevT=prop prevCap=maxmin nextW=de nextT=prp nextCap=min prev2W=; prev2T=punc prev2Cap=null next2W=Oliveira next2T=prop next2Cap=maxmin palpite=I_PESSOA
de prp ini=ncap cap=min simb=alpha prevW=Dias prevT=n prevCap=maxmin nextW=Oliveira nextT=prop nextCap=maxmin prev2W=Anderson prev2T=prop prev2Cap=maxmin next2W=e next2T=conj-c next2Cap=min palpite=I_PESSOA
Oliveira prop ini=cap cap=maxmin simb=alpha prevW=de prevT=prp prevCap=min nextW=e nextT=conj-c nextCap=min prev2W=Dias prev2T=n prev2Cap=maxmin next2W=Stéfano next2T=prop next2Cap=maxmin palpite=I_PESSOA
e conj-c ini=ncap cap=min simb=alpha prevW=Oliveira prevT=prop prevCap=maxmin nextW=Stéfano nextT=prop nextCap=maxmin prev2W=de prev2T=prp prev2Cap=min next2W=Terci next2T=prop next2Cap=maxmin palpite=O
Stéfano prop ini=cap cap=maxmin simb=alpha prevW=e prevT=conj-c prevCap=min nextW=Terci nextT=prop nextCap=maxmin prev2W=Oliveira prev2T=prop prev2Cap=maxmin next2W=Gasperazzo next2T=prop next2Cap=maxmin palpite=O
Terci prop ini=cap cap=maxmin simb=alpha prevW=Stéfano prevT=prop prevCap=maxmin nextW=Gasperazzo nextT=prop nextCap=maxmin prev2W=e prev2T=conj-c prev2Cap=min next2W=. next2T=punc next2Cap=null palpite=O
Gasperazzo prop ini=cap cap=maxmin simb=alpha prevW=Terci prevT=prop prevCap=maxmin nextW=. nextT=punc nextCap=null prev2W=Stéfano prev2T=prop prev2Cap=maxmin next2W=null next2T=null next2Cap=null palpite=O
. punc ini=simb cap=null simb=null prevW=Gasperazzo prevT=prop prevCap=maxmin nextW=null nextT=null nextCap=null prev2W=Terci prev2T=prop prev2Cap=maxmin next2W=null next2T=null next2Cap=null palpite=O
